NO   ./textures/n_tex.xpm 
SO ./textures/s_tex.xpm                             
EA ./textures/e_tex.xpm
WE   ./textures/n_tex.xpm 

F 54,78,87
C   255,240,255
C   255,240,255

111    111111111111 1111111
1011111100000110011111000001
1000000000000000000100000001
1000000000000111100100000001
1000011100000000000100000001
1000000000000000000100000001
1000000000001110000100000001
100000000010000000010S000001
1000000001 100000000000000001
1111111111111111111111111111

