NO   ./textures/test_n_letter.xpm  
SO ./textures/test_s_letter.xpm
WE ./textures/test_w_letter.xpm
EA ./textures/test_e_letter.xpm

F      54,78,87
C   245,45,31


111111111111111111111111111111111
100000000000000000000000000000001
100000000000000000000000000000001
100000000000000000000000000000001
100000000000000000000000000000001
100000000000000N00000000000000001
100000000000000000000000000000001
100000000000000000000000000000001
100000000000000000000000000000001
111111111111111111111111111111111
