NO ./textures/n_tex.xpm
SO ./textures/s_tex.xpm                             
EA ./textures/e_tex.xpm
WE ./textures/w_tex.xpm

F 54, 78, 255
C     85,178,245

11111111
10N00111
10000901
10000101
11111111

