NO   ./textures/testdrinkshelf.xpm  
SO ./textures/bricks.xpm
WE ./textures/white.xpm
EA ./textures/white.xpm

F      54,78,87
C   245,45,31


111    111111111111 1111111
1011111100000110011111000001
1000000000000000000100000001
1000000000000111100100000001
1000011100000000000100000001
1000000000000000000100000001
1000000000001110000100000001
100000000010000000010N000001
1000000001 100000000000000001
1111111111111111111111111111
